src/ui/game_hud/game_hud.gd:22:	var max_health = Config.get_value("player.health.max_health", 5)
src/ui/game_hud/game_hud.gd:25:	boss_health_bar.max_value = Config.get_value("boss.stats.health", 30)
src/core/data/config/config.gd:14:# Example: Config.get_value("player.physics.speed")
src/entities/boss/base_boss.gd:31:	b_data.patrol_speed = Config.get_value("boss.stats.patrol_speed", 100.0)
src/entities/boss/base_boss.gd:57:		velocity.y += Config.get_value("general.physics.gravity") * delta
src/entities/components/combat_component.gd:23:	p_data.attack_cooldown_timer = Config.get_value("player.combat.attack_cooldown")
src/entities/components/combat_component.gd:37:	owner_node.velocity.y = -Config.get_value("player.physics.pogo_force")
src/entities/components/combat_component.gd:40:	p_data.air_jumps_left = Config.get_value("player.physics.max_air_jumps")
src/entities/components/health_component.gd:47:	max_health = Config.get_value(config_paths.max_health, 10)
src/entities/components/health_component.gd:48:	invincibility_duration = Config.get_value(config_paths.get("invincibility", "player.health.invincibility_duration"), 1.0)
src/entities/components/health_component.gd:84:	var knockback_speed = Config.get_value(_knockback_config.speed, 400.0)
src/entities/components/health_component.gd:86:		knockback_speed = Config.get_value(_knockback_config.hazard_speed, knockback_speed)
src/entities/components/input_component.gd:24:		p_data.jump_buffer_timer = Config.get_value("player.physics.jump_buffer")
src/entities/components/input_component.gd:35:			if p_data.charge_timer >= Config.get_value("player.combat.charge_time"):
src/entities/player/player.gd:87:		p_data.wall_coyote_timer = Config.get_value("player.physics.wall_coyote_time")
src/entities/player/player.gd:120:	velocity.x = Input.get_axis("ui_left", "ui_right") * Config.get_value("player.physics.speed")
src/entities/player/player.gd:144:	if p_data.healing_charges >= Config.get_value("player.health.max_healing_charges"): return
src/entities/player/player.gd:146:	if p_data.determination_counter >= Config.get_value("player.combat.determination_per_charge"):
src/entities/player/states/state_jump.gd:6:	player.velocity.y = -Config.get_value("player.physics.jump_force")
src/entities/player/states/state_jump.gd:15:		player.velocity.y *= Config.get_value("player.physics.jump_release_dampener")
src/entities/player/states/state_jump.gd:26:	player.velocity.y += Config.get_value("general.physics.gravity") * delta
src/entities/player/states/state_dash.gd:9:	p_data.dash_duration_timer = Config.get_value("player.physics.dash_duration")
src/entities/player/states/state_dash.gd:10:	p_data.dash_cooldown_timer = Config.get_value("player.physics.dash_cooldown")
src/entities/player/states/state_dash.gd:11:	player.velocity = _get_dash_direction() * Config.get_value("player.physics.dash_speed")
src/entities/player/states/state_heal.gd:7:	player.healing_timer.start(Config.get_value("player.health.heal_duration"))
src/entities/player/states/state_wall_slide.gd:7:	p_data.air_jumps_left = Config.get_value("player.physics.max_air_jumps")
src/entities/player/states/state_wall_slide.gd:14:	var gravity = Config.get_value("general.physics.gravity")
src/entities/player/states/state_wall_slide.gd:15:	var wall_slide_speed = Config.get_value("player.physics.wall_slide_speed")
src/entities/player/states/state_wall_slide.gd:38:	player.velocity.y = -Config.get_value("player.physics.wall_jump_force_y")
src/entities/player/states/state_wall_slide.gd:39:	player.velocity.x = p_data.last_wall_normal.x * Config.get_value("player.physics.wall_jump_force_x")
src/entities/player/states/state_attack.gd:6:	p_data.attack_duration_timer = Config.get_value("player.combat.attack_duration")
src/entities/player/states/state_attack.gd:7:	p_data.attack_cooldown_timer = Config.get_value("player.combat.attack_cooldown")
src/entities/player/states/state_attack.gd:33:		var friction = Config.get_value("player.combat.attack_friction")
src/entities/player/states/state_hurt.gd:8:	p_data.knockback_timer = Config.get_value("player.combat.knockback_duration")
src/entities/player/states/state_hurt.gd:11:	player.velocity.y += Config.get_value("general.physics.gravity") * delta
src/entities/player/states/state_fall.gd:27:		gravity_multiplier = Config.get_value("player.physics.fast_fall_gravity_multiplier")
src/entities/player/states/state_fall.gd:28:	player.velocity.y += Config.get_value("general.physics.gravity") * gravity_multiplier * delta
src/entities/player/states/state_fall.gd:40:	player.velocity.x = p_data.last_wall_normal.x * Config.get_value("player.physics.wall_jump_force_x")
src/entities/player/states/state_move.gd:6:	p_data.air_jumps_left = Config.get_value("player.physics.max_air_jumps")
src/entities/player/states/state_move.gd:10:	p_data.coyote_timer = Config.get_value("player.physics.coyote_time")
src/entities/player/states/state_move.gd:12:	player.velocity.y += Config.get_value("general.physics.gravity") * delta
